S. No,Crime Head,Cases Pending Investi-gation from Previous Year,Cases Reported during the year,Cases Reopened for Investi-gation,Total Cases for Investi-gation (Col.3+ Col.4+ Col.5),Cases Not Investi-gated Under 157_1_b CRPC,Cases Transferred to other State or Agency,Cases With-drawn by the Govt during investi-gation,Final Report -  Cases Ended as FR Non Cognizable,Final Report -  Cases Ended as Final Report False,Final Report -  Cases Ended as Mistake of Fact or of Law or Civil Dispute,Final Report -  Cases True but Insufficient Evidence or Untraced or No Clue,Final Report -  Cases Abated during Investigation,Final Report -  Total (Col.10+ Col.11+ Col.12+ Col.13+ Col.14),Chargesheets submitted -  Cases Chargesheeted Out of Cases from Previous Year,Chargesheets submitted -  Cases Charge- sheeted Out of Cases during the Year,Chargesheets submitted -  Cases Chargesheeted (Col.16+ Col.17),Total Cases Disposed Off by Police (Col.7+ Col.8+ Col.15+ Col.18),Cases Quashed at Investigation Stage,Cases Stayed at Investigation Stage,Cases Pending Investigation at End of the Year (Col.6- Col.9- Col.19- Col.20),Charge-Sheeting Rate (Col.18/ Col.19) *100,Pen- dency Percent age (Col.22/ Col.6) *100
1,Tampering computer source documents,165,173,0,338,0,0,0,0,3,6,90,0,99,12,30,42,141,1,1,196,29.8,58
2.1.1,Ransom-ware Computer Related Offences,995,1023,0,2018,0,0,0,12,25,5,871,0,913,264,141,405,1318,1,0,699,30.7,34.6
2.1.2,Offences other than Ransom-ware Computer Related Offences,2732,3444,0,6176,0,2,0,4,38,119,1606,0,1767,630,573,1203,2972,3,1,3201,40.5,51.8
2.2,Dishonestly receiving stolen computer resource or communication device,396,558,0,954,0,1,0,0,16,40,208,0,264,65,106,171,436,3,0,515,39.2,54
2.3,Identity Theft,8634,12255,0,20889,0,91,0,0,138,117,1633,3,1891,246,317,563,2545,5,0,18339,22.1,87.8
2.4,Cheating by personation by using computer resource,2572,5520,3,8095,0,15,0,0,53,105,1229,49,1436,398,743,1141,2592,8,1,5495,44,67.9
2.5,Violation of Privacy,379,812,1,1192,0,1,0,0,10,11,153,0,174,150,69,219,394,2,1,796,55.6,66.8
3,Cyber Terrorism,23,12,0,35,0,0,0,0,2,1,3,0,6,0,3,3,9,0,0,26,33.3,74.3
4.1,Publishing or transmitting obscene material in Electronic Form,1065,1845,0,2910,0,5,0,0,42,68,388,0,498,238,504,742,1245,3,0,1662,59.6,57.1
4.2,Publishing or transmitting of material containing Sexually explicit act in electronic form,982,1394,2,2378,0,1,0,0,29,35,213,4,281,157,403,560,842,4,0,1532,66.5,64.4
4.3,Publishing or transmitting of material depicting children in Sexually explicit act in electronic form,71,102,0,173,0,0,0,0,0,4,20,0,24,10,47,57,81,0,0,92,70.4,53.2
4.4,Preservation and retention of information by intermediaries,33,14,0,47,0,0,0,0,1,0,8,1,10,3,1,4,14,0,0,33,28.6,70.2
4.5,Other Sections 67 IT Act,481,832,0,1313,0,0,0,1,160,42,93,0,296,50,181,231,527,0,0,786,43.8,59.9
5,Interception or Monitoring or decryption of Information,5,9,0,14,0,0,0,0,0,0,2,0,2,1,7,8,10,0,0,4,80,28.6
6,Un-authorized access/attempt to  access to protected computer system,0,2,0,2,0,0,0,0,0,0,0,0,0,0,2,2,2,0,0,0,100,0
7,Abetment to Commit Offences,1,0,0,1,0,0,0,0,0,0,0,0,0,0,0,0,0,0,0,1,NA,100
8,Attempt to Commit Offences,5,14,0,19,0,0,0,0,0,0,1,0,1,0,10,10,11,0,0,8,90.9,42.1
9,Other Sections of IT Act,1244,2720,0,3964,0,1,0,0,694,87,1450,15,2246,237,254,491,2738,4,0,1222,17.9,30.8
11,Abetment of Suicide (Online),1,8,0,9,0,0,0,0,0,0,0,0,0,1,4,5,5,0,0,4,100,44.4
12,Cyber Stalking/Bullying of Women/Children,559,777,0,1336,0,3,0,0,28,12,78,6,124,149,317,466,593,6,0,737,78.6,55.2
13,Data theft,268,285,0,553,0,0,0,0,0,24,162,0,186,4,24,28,214,0,0,339,13.1,61.3
14.1,Credit Card/Debit Card fraud,513,367,0,880,0,0,0,0,2,10,132,2,146,37,30,67,213,1,0,666,31.5,75.7
14.2,ATMs fraud,1860,2067,5,3932,0,0,0,0,76,117,554,0,747,129,319,448,1195,1,0,2736,37.5,69.6
14.3,Online Banking Fraud,1136,2093,0,3229,0,2,0,0,14,85,588,2,689,117,145,262,953,9,0,2267,27.5,70.2
14.4,OTP Frauds,375,549,6,930,0,0,0,0,1,5,209,0,215,25,69,94,309,0,0,621,30.4,66.8
14.5,Others,635,1157,0,1792,0,0,0,0,44,69,341,0,454,61,188,249,703,1,0,1088,35.4,60.7
15,Cheating,4298,3393,1,7692,0,4,0,0,29,90,1098,1,1218,227,309,536,1758,4,0,5930,30.5,77.1
16,Forgery,380,512,0,892,0,0,0,0,1,13,25,0,39,99,28,127,166,3,0,723,76.5,81.1
17,Defamation/Morphing,19,19,0,38,0,0,0,0,0,0,1,0,1,1,3,4,5,0,0,33,80,86.8
18,Fake Profile,76,87,0,163,0,0,0,0,8,0,22,0,30,16,19,35,65,0,0,98,53.8,60.1
19.1,Currency Counterfeiting,13,5,0,18,0,0,0,0,0,0,1,0,1,1,3,4,5,0,0,13,80,72.2
19.2,Stamps Counterfeiting,1,0,0,1,0,0,0,0,0,0,0,0,0,1,0,1,1,0,0,0,100,0
20,Cyber Blackmailing/Threatening,293,372,3,668,0,0,0,0,10,12,71,0,93,25,85,110,203,0,0,465,54.2,69.6
21,Fake News on Social Media ,153,190,0,343,0,1,0,0,1,10,15,0,26,8,52,60,87,0,0,256,69,74.6
22,Other Offences,1520,1849,3,3372,0,2,1,1,72,71,239,1,384,230,651,881,1267,8,0,2096,69.5,62.2
24,Gambling Act (Online Gambling),22,22,0,44,0,0,0,0,0,0,1,0,1,2,14,16,17,0,0,27,94.1,61.4
25,Lotteries Act (Online Lotteries),14,9,0,23,0,0,0,0,0,0,0,0,0,1,0,1,1,0,0,22,100,95.7
26,Copy Right Act,123,34,0,157,0,0,0,0,9,0,11,0,20,7,5,12,32,0,0,125,37.5,79.6
27,Trade Marks Act,13,0,0,13,0,0,0,0,0,0,0,0,0,2,0,2,2,0,0,11,100,84.6
28,Other SLL Crimes,44,22,0,66,0,1,0,0,0,2,1,0,3,3,6,9,13,0,0,53,69.2,80.3
